"province_code","province_name_eng","district_sub_code","district_or_subdivision_name_eng","vr_total_final_19","vr_total_prelim_19","vr_total_final_18","vr_2019_net_change","vr_2019_pct_change","vr_2018_2019_net_change","vr_2018_2019_pct_change"
"01","KABUL","0101-01","KABUL CITY NAHIA 01",21440,20490,20456,950,0.0463640800390434,984,0.0481032459913962
"01","KABUL","0101-02","KABUL CITY NAHIA 02",34181,32569,32461,1612,0.0494949184807639,1720,0.0529866609161763
"01","KABUL","0101-03","KABUL CITY NAHIA 03",41305,40013,39868,1292,0.0322895059105791,1437,0.0360439450185613
"01","KABUL","0101-04","KABUL CITY NAHIA 04",53716,51324,52541,2392,0.0466058763931104,1175,0.0223634875620944
"01","KABUL","0101-05","KABUL CITY NAHIA 05",80208,78096,78401,2112,0.0270436385986478,1807,0.0230481754059259
"01","KABUL","0101-06","KABUL CITY NAHIA 06",75823,72155,72559,3668,0.0508350079689557,3264,0.0449840819195413
"01","KABUL","0101-07","KABUL CITY NAHIA 07",76666,73544,73461,3122,0.0424507777656913,3205,0.0436285920420359
"01","KABUL","0101-08","KABUL CITY NAHIA 08",94772,91619,91427,3153,0.0344142590510702,3345,0.0365865663316088
"01","KABUL","0101-09","KABUL CITY NAHIA 09",56640,54625,54604,2015,0.0368878718535469,2036,0.0372866456669841
"01","KABUL","0101-10","KABUL CITY NAHIA 10",68143,64863,64723,3280,0.050568120500131,3420,0.0528405667228033
"01","KABUL","0101-11","KABUL CITY NAHIA 11",81571,80644,80107,927,0.0114949655275036,1464,0.0182755564432571
"01","KABUL","0101-12","KABUL CITY NAHIA 12",98473,94580,94836,3893,0.0411609219708184,3637,0.038350415454047
"01","KABUL","0101-13","KABUL CITY NAHIA 13",136800,129809,130277,6991,0.0538560500427551,6523,0.050070234960891
"01","KABUL","0101-14","KABUL CITY NAHIA 14",8238,7952,7832,286,0.0359657947686117,406,0.0518386108273749
"01","KABUL","0101-15","KABUL CITY NAHIA 15",74102,71898,72088,2204,0.0306545383738073,2014,0.0279380756852736
"01","KABUL","0101-16","KABUL CITY NAHIA 16",44138,42912,42900,1226,0.0285700969425802,1238,0.0288578088578089
"01","KABUL","0101-17","KABUL CITY NAHIA 17",56287,55158,55145,1129,0.0204684723884115,1142,0.0207090398041527
"01","KABUL","0101-18","KABUL CITY NAHIA 18",14715,12975,13012,1740,0.134104046242775,1703,0.130879188441439
"01","KABUL","0101-19","KABUL CITY NAHIA 19",13603,12412,12357,1191,0.0959555269094425,1246,0.100833535647811
"01","KABUL","0101-21","KABUL CITY NAHIA 21",65103,64503,64535,600,0.00930189293521232,568,0.00880142558301697
"01","KABUL","0101-22","KABUL CITY NAHIA 22",7368,6967,6953,401,0.0575570546863786,415,0.059686466273551
"01","KABUL","0102","PAGHMAN",60545,57867,58124,2678,0.0462785352618937,2421,0.0416523295024431
"01","KABUL","0103","CHAHARASYAB",35880,34958,34963,922,0.026374506550718,917,0.0262277264536796
"01","KABUL","0104","BAGRAMI",87785,83949,84149,3836,0.0456944097011281,3636,0.0432090696264959
"01","KABUL","0105","DEHSABZ",43744,42778,42927,966,0.0225817008742812,817,0.0190323106669462
"01","KABUL","0106","SHAKARDARA",41788,41167,41259,621,0.0150848980979911,529,0.0128214450180567
"01","KABUL","0107","MOSAHI",28636,25074,25076,3562,0.142059503868549,3560,0.141968416015313
"01","KABUL","0108","MIRBACHAKOT",22792,22479,22573,313,0.0139241069442591,219,0.00970185619988482
"01","KABUL","0109","KHAKEJABAR",18417,17257,17269,1160,0.0672190994958567,1148,0.0664775030401297
"01","KABUL","0110","KALAKAN",14327,13935,13962,392,0.0281306063867958,365,0.026142386477582
"01","KABUL","0111","GULDARA",8645,8446,8468,199,0.0235614492067251,177,0.0209022201228153
"01","KABUL","0112","FARZA",10750,10402,10413,348,0.0334551047875409,337,0.0323633919139537
"01","KABUL","0113","ISTALIF",12835,12176,12227,659,0.054122864651774,608,0.0497260161936697
"01","KABUL","0114","QARABAGH",47825,46793,46876,1032,0.0220545808133695,949,0.0202449014421026
"01","KABUL","0115","SUROBI",59080,55808,57021,3272,0.0586295871559633,2059,0.0361095035162484
"02","KAPISA","0201","MAHMODRAQI",30174,29799,29650,375,0.0125843149098963,524,0.017672849915683
"02","KAPISA","0202","HISSA-E-DUWUMI KOHISTAN",23118,22853,22889,265,0.0115958517481293,229,0.0100048058019136
"02","KAPISA","0203","KOHBAND",21529,20698,20779,831,0.0401488066479853,750,0.0360941335001684
"02","KAPISA","0204","HESE  AWAL KOHESTAN",29551,28500,28644,1051,0.0368771929824561,907,0.0316645719871526
"02","KAPISA","0205","NEJRAB",33268,32540,32647,728,0.0223724646588814,621,0.0190216558948755
"02","KAPISA","0206","TAGAB",19665,19026,19034,639,0.0335856196783349,631,0.0331512031102238
"02","KAPISA","0207","ALASAY",3513,3224,3233,289,0.0896401985111663,280,0.0866068666872873
"03","PARWAN","0301","CHARIKAR",54991,53788,53777,1203,0.0223655834015022,1214,0.0225747066589806
"03","PARWAN","0302","BAGRAM",50466,50540,50392,-74,-0.00146418678274634,74,0.00146848706143832
"03","PARWAN","0303","SHINWARI",15039,14784,14749,255,0.0172483766233766,290,0.0196623499898298
"03","PARWAN","0304","SAYDKHEL",18953,18597,18584,356,0.0191428725063182,369,0.0198557899268188
"03","PARWAN","0305","JABALUSARAJ",22785,21618,21616,1167,0.0539827921176797,1169,0.054080310880829
"03","PARWAN","0306","SALANG",13902,13662,13639,240,0.0175669740887132,263,0.0192829386318645
"03","PARWAN","0307","GHORBAND (SIA GERD)",13682,12725,12751,957,0.0752062868369352,931,0.0730138812642146
"03","PARWAN","0308","KOHESAFI",6207,5844,5842,363,0.0621149897330595,365,0.062478603218076
"03","PARWAN","0309","SURKH PARSA",13106,12760,12765,346,0.027115987460815,341,0.0267136701919311
"03","PARWAN","0310","SHIKHALI",9804,9538,9563,266,0.0278884462151394,241,0.0252012966642267
"04","MAYDANWARDAK","0401","MAYDANSHAHR",22629,21776,22202,853,0.0391715650257164,427,0.0192325015764346
"04","MAYDANWARDAK","0402","NIRKH",15770,11882,12061,3888,0.327217640127925,3709,0.307520106127187
"04","MAYDANWARDAK","0403","JALRIZ",15836,15272,15403,564,0.036930330015715,433,0.0281114068687918
"04","MAYDANWARDAK","0404","CHAK",22768,22066,22261,702,0.0318136499592133,507,0.0227752571762275
"04","MAYDANWARDAK","0405","SAYDABAD",26817,19413,20481,7404,0.381393911296554,6336,0.3093598945364
"04","MAYDANWARDAK","0406","DAYMIRDAD",5367,2451,2478,2916,1.18971848225214,2889,1.16585956416465
"04","MAYDANWARDAK","0407","HISE AWAL BEHSOD",14950,13407,14236,1543,0.115089132542702,714,0.0501545377915145
"04","MAYDANWARDAK","0408","JAGHATO",3014,2929,2939,85,0.0290201433936497,75,0.0255188839741409
"04","MAYDANWARDAK","0409","MARKAZ BIHSOD",35093,32899,32974,2194,0.0666889571111584,2119,0.0642627524716443
"05","LOGAR","0501","PULE ALAM",43711,42605,42936,1106,0.0259593944372726,775,0.01805012111049
"05","LOGAR","0502","BARAKIBARAK",3296,2678,2689,618,0.230769230769231,607,0.225734473782075
"05","LOGAR","0503","CHARKH",2382,2183,2193,199,0.0911589555657352,189,0.0861833105335157
"05","LOGAR","0504","KHOSHI",13349,12897,12894,452,0.0350469101341397,455,0.0352877307274701
"05","LOGAR","0505","MUHAMMADAGHA",38464,35216,35462,3248,0.0922308041799182,3002,0.0846539958265185
"05","LOGAR","0506","KHARWAR",171,41,41,130,3.17073170731707,130,3.17073170731707
"05","LOGAR","0507","AZRA",6186,5537,5555,649,0.117211486364457,631,0.113591359135914
"06","NANGARHAR","0601-01","JALALABAD NAHIA 01",24425,22276,22211,2149,0.0964715388759203,2214,0.0996803385709783
"06","NANGARHAR","0601-02","JALALABAD NAHIA 02",29766,28813,28705,953,0.0330753479332246,1061,0.0369622017070197
"06","NANGARHAR","0601-03","JALALABAD NAHIA 03",31838,31046,30903,792,0.0255105327578432,935,0.0302559622043167
"06","NANGARHAR","0601-04","JALALABAD NAHIA 04",41712,40697,40507,1015,0.0249404132982775,1205,0.0297479447996643
"06","NANGARHAR","0601-05","JALALABAD NAHIA 05",20070,19140,19063,930,0.04858934169279,1007,0.0528248439385196
"06","NANGARHAR","0601-06","JALALABAD NAHIA 06",21118,19711,19625,1407,0.0713814621277459,1493,0.0760764331210191
"06","NANGARHAR","0602","BIHSOD",77575,73201,73478,4374,0.0597532820589883,4097,0.0557581861237377
"06","NANGARHAR","0603","SURKHROD",76839,74701,74887,2138,0.0286207681289407,1952,0.0260659393486186
"06","NANGARHAR","0604","CHAPARHAR",33774,32204,32266,1570,0.0487517078623773,1508,0.0467365028203062
"06","NANGARHAR","0605","KAMA",49640,48751,48832,889,0.0182355233738795,808,0.0165465268676278
"06","NANGARHAR","0606","KOZ KUNAR",37794,34150,34163,3644,0.106705710102489,3631,0.106284576881421
"06","NANGARHAR","0607","RODAT",45306,39827,39284,5479,0.137569990207648,6022,0.153293961918338
"06","NANGARHAR","0608","KHOGYANI",54455,52428,52504,2027,0.0386625467307546,1951,0.0371590735943928
"06","NANGARHAR","0609","BATIKOT",35914,33033,33022,2881,0.0872158144885418,2892,0.0875779783174853
"06","NANGARHAR","0610","DEHBALA",10564,9054,9049,1510,0.166777115087254,1515,0.167421814565145
"06","NANGARHAR","0611","PACHERAGAM",19147,17804,17826,1343,0.0754324870815547,1321,0.0741052395377538
"06","NANGARHAR","0612","DARA NOOR",36675,34327,34342,2348,0.068400967168701,2333,0.0679343078446217
"06","NANGARHAR","0613","KOT",28016,26695,26692,1321,0.049484922270088,1324,0.0496028772665967
"06","NANGARHAR","0614","GOSHTA",22191,20582,20582,1609,0.078175104460208,1609,0.078175104460208
"06","NANGARHAR","0615","ACHEEN",23161,21863,22056,1298,0.0593697113845309,1105,0.0500997461008342
"06","NANGARHAR","0616","SHINWAR",27714,25153,25209,2561,0.101816880690176,2505,0.0993692728787338
"06","NANGARHAR","0617","MUHMAND DARA",31169,29081,29685,2088,0.071799456689935,1484,0.0499915782381674
"06","NANGARHAR","0618","LAL POOR",13963,13074,13076,889,0.0679975523940646,887,0.0678342000611808
"06","NANGARHAR","0619","SHIRZAD",1774,1717,1738,57,0.0331974373907979,36,0.0207134637514384
"06","NANGARHAR","0620","NAZYAN",16834,15868,15840,966,0.0608772372069574,994,0.0627525252525253
"06","NANGARHAR","0621","HISARAK",5760,5629,5576,131,0.0232723396695683,184,0.0329985652797704
"06","NANGARHAR","0622","DURBABA",21407,20343,20342,1064,0.052303003490144,1065,0.0523547340477829
"06","NANGARHAR","0623","SPIN GHAR",17642,16194,16017,1448,0.089415833024577,1625,0.1014547043766
"07","LAGHMAN","0701","MEHTARLAM",70479,66274,66343,4205,0.0634487129190935,4136,0.0623426736807199
"07","LAGHMAN","0702","QARGHAYE",64038,59326,59406,4712,0.0794255469777164,4632,0.077971922028078
"07","LAGHMAN","0703","ALISHENG",12282,11408,11398,874,0.0766129032258065,884,0.0775574662221442
"07","LAGHMAN","0704","ALINGAR",12877,12190,12159,687,0.056357670221493,718,0.0590509087918414
"07","LAGHMAN","0705","DAWLATSHAH",13074,11860,11867,1214,0.102360876897133,1207,0.101710626106008
"07","LAGHMAN","0706","BAD PAKH",536,499,495,37,0.0741482965931864,41,0.0828282828282828
"08","PANJSHIR","0801","BAZARAK",13239,12697,12656,542,0.0426872489564464,583,0.0460651074589128
"08","PANJSHIR","0802","RUKHA",6036,5591,5672,445,0.079592201752817,364,0.0641748942172073
"08","PANJSHIR","0803","DARA",9099,8288,8350,811,0.0978523166023166,749,0.0897005988023952
"08","PANJSHIR","0804","KHENJ (HESAE AWAL)",15624,15017,15072,607,0.0404208563627888,552,0.036624203821656
"08","PANJSHIR","0805","ONABA",12166,11657,11699,509,0.0436647507935146,467,0.0399179417044192
"08","PANJSHIR","0806","SHUTUL",5354,5075,5144,279,0.0549753694581281,210,0.0408242612752722
"08","PANJSHIR","0807","PARYAN",8215,7875,7916,340,0.0431746031746032,299,0.0377716018191006
"08","PANJSHIR","0808","ABSHAR",7572,7238,7257,334,0.0461453440176844,315,0.0434063662670525
"09","BAGHLAN","0901","PULE KHUMRI",57601,55791,56130,1810,0.0324425086483483,1471,0.0262070194192054
"09","BAGHLAN","0902","DAHANAE GHORI",0,0,0,0,NA,0,NA
"09","BAGHLAN","0903","DOSHI",30116,29203,29314,913,0.0312639112419957,802,0.0273589411202838
"09","BAGHLAN","0904","NAHREEN",55616,54049,54055,1567,0.0289922107717072,1561,0.0288779946350939
"09","BAGHLAN","0905","BAGHLAN JADID",87364,80162,80892,7202,0.0898430677877299,6472,0.0800079117836127
"09","BAGHLAN","0906","KHINJAN",12761,12614,12618,147,0.01165371809101,143,0.0113330163258837
"09","BAGHLAN","0907","ANDARAB",11386,11012,10995,374,0.0339629495096259,391,0.0355616189176899
"09","BAGHLAN","0908","DEHSALAH",21104,19496,19653,1608,0.0824784571194091,1451,0.0738309672823488
"09","BAGHLAN","0909","KHWAJAHEJRAN",22861,21033,21417,1828,0.086911044549042,1444,0.0674230751272354
"09","BAGHLAN","0910","BORKA",22059,19995,20016,2064,0.103225806451613,2043,0.102068345323741
"09","BAGHLAN","0911","TALA WA BARFAK",35559,33302,33783,2257,0.0677737072848478,1776,0.0525708196430157
"09","BAGHLAN","0912","PULE HESAR",20593,19433,19432,1160,0.0596922760253178,1161,0.0597468093865788
"09","BAGHLAN","0913","KHOST WA FERENG",41130,38695,38655,2435,0.0629280268768575,2475,0.0640279394644936
"09","BAGHLAN","0914","GUZARGAHE NOOR",7199,7101,7130,98,0.0138008731164625,69,0.00967741935483871
"09","BAGHLAN","0915","FIRING GHARO",11659,10455,10494,1204,0.115160210425634,1165,0.111015818562988
"10","BAMYAN","1001","BAMYAN",44191,43144,43130,1047,0.024267569071018,1061,0.0246000463714352
"10","BAMYAN","1002","SHEBAR",9316,9030,9027,286,0.031672203765227,289,0.032015065913371
"10","BAMYAN","1003","SAYGHAN",11801,11427,11423,374,0.0327295003062921,378,0.0330911319268143
"10","BAMYAN","1004","KAHMARD",20748,20607,20604,141,0.00684233512883971,144,0.0069889341875364
"10","BAMYAN","1005","YAKAWLANG",25318,24650,24650,668,0.0270993914807302,668,0.0270993914807302
"10","BAMYAN","1006","PANJAB",17739,17158,17162,581,0.0338617554493531,577,0.0336207901177019
"10","BAMYAN","1007","WARAS",29509,28738,28713,771,0.0268285893242397,796,0.0277226343468115
"10","BAMYAN","1008","YAKAWLANG NUMBER 2",12853,12566,12594,287,0.0228394079261499,259,0.0205653485786883
"11","GHAZNI","1101","GHAZNI",42561,0,0,42561,Inf,42561,Inf
"11","GHAZNI","1102","WALEMUHAMMAD SHAHEED",871,0,0,871,Inf,871,Inf
"11","GHAZNI","1103","KHWAJAUMARI",2660,0,0,2660,Inf,2660,Inf
"11","GHAZNI","1104","WAGHAZ",2136,0,0,2136,Inf,2136,Inf
"11","GHAZNI","1105","DEHYAK",2835,0,0,2835,Inf,2835,Inf
"11","GHAZNI","1106","JAGHATO",0,0,0,0,NA,0,NA
"11","GHAZNI","1107","ANDAR",7279,0,0,7279,Inf,7279,Inf
"11","GHAZNI","1108","ZANAKHAN",918,0,0,918,Inf,918,Inf
"11","GHAZNI","1109","RASHEEDAN",0,0,0,0,NA,0,NA
"11","GHAZNI","1110","NAWUR",53458,0,0,53458,Inf,53458,Inf
"11","GHAZNI","1111","QARABAGH",1704,0,0,1704,Inf,1704,Inf
"11","GHAZNI","1112","GEERO",0,0,0,0,NA,0,NA
"11","GHAZNI","1113","AB BAND",5701,0,0,5701,Inf,5701,Inf
"11","GHAZNI","1114","JAGHORI",50453,0,0,50453,Inf,50453,Inf
"11","GHAZNI","1115","MUQUR",19481,0,0,19481,Inf,19481,Inf
"11","GHAZNI","1116","MALESTAN",35160,0,0,35160,Inf,35160,Inf
"11","GHAZNI","1117","GELAN",9996,0,0,9996,Inf,9996,Inf
"11","GHAZNI","1118","AJRESTAN",0,0,0,0,NA,0,NA
"11","GHAZNI","1119","NAWA",0,0,0,0,NA,0,NA
"12","PAKTIKA","1201","SHARAN",20642,19287,19249,1355,0.0702545756208845,1393,0.072367395708868
"12","PAKTIKA","1202","MATAKHAN",14559,13867,13889,692,0.0499026465709959,670,0.0482396140830873
"12","PAKTIKA","1203","YOSUFKHEL",10293,9547,9557,746,0.0781397297580392,736,0.077011614523386
"12","PAKTIKA","1204","YAHYAKHEL",15835,14620,14611,1215,0.0831053351573187,1224,0.083772500171104
"12","PAKTIKA","1205","SAR RAWZA",6237,5624,5622,613,0.108997155049787,615,0.109391675560299
"12","PAKTIKA","1206","OMNA",3333,1275,1280,2058,1.61411764705882,2053,1.60390625
"12","PAKTIKA","1207","ZARGHONSHAHR",26977,25014,25033,1963,0.0784760534100904,1944,0.0776574921104143
"12","PAKTIKA","1208","GOMAL",14650,14151,14143,499,0.0352625256165642,507,0.0358481227462349
"12","PAKTIKA","1209","JANIKHEL",19298,14414,14450,4884,0.338837241570695,4848,0.335501730103806
"12","PAKTIKA","1210","SAROBI",16532,15496,15529,1036,0.0668559628291172,1003,0.0645888337948355
"12","PAKTIKA","1211","URGUN",22134,19025,19036,3109,0.163416557161629,3098,0.162744274007144
"12","PAKTIKA","1212","‌‌ZEEROK‌‎‌‎‌‎‌‎",9934,9483,9512,451,0.0475587894126331,422,0.0443650126156434
"12","PAKTIKA","1213","NEEKA‌‎‌‎‌‎‌‎",6963,6650,6641,313,0.0470676691729323,322,0.0484866736937208
"12","PAKTIKA","1214","BARAL",10161,9216,9566,945,0.1025390625,595,0.0621994564081121
"12","PAKTIKA","1215","GYAN",0,0,0,0,NA,0,NA
"12","PAKTIKA","1216","DELA",5754,5459,5459,295,0.0540392013189229,295,0.0540392013189229
"12","PAKTIKA","1217","WAZAKHUA",11322,9842,9845,1480,0.150375939849624,1477,0.150025393600813
"12","PAKTIKA","1218","WORMAMAY",13184,6880,6891,6304,0.916279069767442,6293,0.913220142214483
"12","PAKTIKA","1219","TURWO",7919,7201,7202,718,0.0997083738369671,717,0.0995556789780617
"13","PAKTYA","1301","GARDEZ",52483,50007,49843,2476,0.0495130681704561,2640,0.0529663142266718
"13","PAKTYA","1302","AHMADABA",27756,26329,26948,1427,0.0541987922063124,808,0.0299836722576815
"13","PAKTYA","1303","ZURMAT",34543,33320,33363,1223,0.0367046818727491,1180,0.0353685220154063
"13","PAKTYA","1304","SHUWAK",8757,8569,8562,188,0.0219395495390361,195,0.0227750525578136
"13","PAKTYA","1305","ZADRAN",19233,18933,18949,300,0.015845349389954,284,0.0149875982901472
"13","PAKTYA","1306","SAYEDKARAM",22522,21531,21863,991,0.0460266592355209,659,0.0301422494625623
"13","PAKTYA","1307","JAJEE",60136,57027,57540,3109,0.0545180353166044,2596,0.0451164407368787
"13","PAKTYA","1308","LEJA AHMADKHEL",25700,25130,25124,570,0.0226820533227218,576,0.0229262856233084
"13","PAKTYA","1309","JANIKHEL",22532,21317,21326,1215,0.0569967631467843,1206,0.0565506892994467
"13","PAKTYA","1310","CHAMKANI",35231,35260,35257,-29,-0.000822461712989223,-26,-0.000737442210057577
"13","PAKTYA","1311","DAND WA PATAN",28685,27374,27375,1311,0.0478921604442171,1310,0.0478538812785388
"13","PAKTYA","1312","LEJAMANGAL",19631,19253,19252,378,0.0196333039006908,379,0.0196862663619364
"13","PAKTYA","1313","MEARZAKA",20359,17102,17124,3257,0.190445561922582,3235,0.188916141088531
"13","PAKTYA","1314","GARDA SIRAY",9272,9047,9136,225,0.0248701226926053,136,0.0148861646234676
"13","PAKTYA","1315","ROHANI BABA",13969,13466,13491,503,0.0373533343234814,478,0.0354310280928026
"14","KHOST","1401","KHOST (MATON)",73729,68141,68115,5588,0.0820064278481384,5614,0.082419437715628
"14","KHOST","1402","MANDOZAY",19703,18547,18549,1156,0.0623281393217232,1154,0.0622135964202922
"14","KHOST","1403","GURBUZ",14985,13123,13118,1862,0.141888287739084,1867,0.14232352492758
"14","KHOST","1404","TANI",23350,21956,21959,1394,0.063490617598834,1391,0.0633453253791156
"14","KHOST","1405","MOSAKHEL",15052,14336,14328,716,0.0499441964285714,724,0.0505304299274149
"14","KHOST","1406","NADIRSHAHKOT",9312,8741,8748,571,0.0653243336002746,564,0.0644718792866941
"14","KHOST","1407","SABARI",23797,22341,22925,1456,0.0651716574907121,872,0.0380370774263904
"14","KHOST","1408","TIREZAYE",18569,16821,16835,1748,0.10391772189525,1734,0.102999702999703
"14","KHOST","1409","BAK",14666,9823,9822,4843,0.493026570294207,4844,0.493178578700876
"14","KHOST","1410","QALANDAR",7682,7042,7049,640,0.0908832717977847,633,0.0897999716271812
"14","KHOST","1411","SPERA",11655,10306,10308,1349,0.130894624490588,1347,0.130675203725262
"14","KHOST","1412","SHAMAL",6790,6634,6634,156,0.0235152246005427,156,0.0235152246005427
"14","KHOST","1413","JAJIMAYDAN",18826,16189,16192,2637,0.162888380999444,2634,0.162672924901186
"15","KUNARHA","1501","ASADABAD",23402,21058,21010,2344,0.111311615538038,2392,0.113850547358401
"15","KUNARHA","1502","MARAWARA",11507,11032,11057,475,0.0430565627266135,450,0.0406982002351452
"15","KUNARHA","1503","WATAPOOR",5930,4499,4500,1431,0.318070682373861,1430,0.317777777777778
"15","KUNARHA","1504","NARANG",11078,10389,10373,689,0.0663201463085956,705,0.0679649088981008
"15","KUNARHA","1505","SARKANI",17295,15182,15172,2113,0.13917797391648,2123,0.139928816240443
"15","KUNARHA","1506","SHEGAL",15106,14409,14420,697,0.048372544937192,686,0.0475728155339806
"15","KUNARHA","1507","DARAE PECH",17636,14383,14426,3253,0.226169783772509,3210,0.222514903646194
"15","KUNARHA","1508","BARKUNAR",10090,8723,8723,1367,0.156712140318698,1367,0.156712140318698
"15","KUNARHA","1509","SAWKAY",16627,15941,15942,686,0.0430336867197792,685,0.0429682599422908
"15","KUNARHA","1510","KHASKUNAR",17674,16505,16513,1169,0.0708270221145108,1161,0.0703082419911585
"15","KUNARHA","1511","GHAZIABAD",3786,3107,3107,679,0.21853878339234,679,0.21853878339234
"15","KUNARHA","1512","DANGAM",6791,5950,5949,841,0.141344537815126,842,0.141536392671037
"15","KUNARHA","1513","CHAPADARA",6187,3386,3388,2801,0.827229769639693,2799,0.826151121605667
"15","KUNARHA","1514","NORGAL",9200,9059,9054,141,0.015564631857821,146,0.0161254694057875
"15","KUNARHA","1515","NARI",14925,13290,13286,1635,0.123024830699774,1639,0.123362938431432
"15","KUNARHA","1516","SHELTAN",3646,2728,2727,918,0.336510263929619,919,0.337000366703337
"16","NOORESTAN","1601","PAROON",12113,10838,10813,1275,0.117641631297287,1300,0.120225654305003
"16","NOORESTAN","1602","WAYGAL",11199,9538,9526,1661,0.174145523170476,1673,0.175624606340542
"16","NOORESTAN","1603","WAMA",16708,12578,12584,4130,0.328351089203371,4124,0.327717736808646
"16","NOORESTAN","1604","NOORGERAM",13545,10237,10245,3308,0.323141545374621,3300,0.322108345534407
"16","NOORESTAN","1605","DOAB",11144,6612,6633,4532,0.685420447670901,4511,0.680084426353083
"16","NOORESTAN","1606","KAMDESH",10189,6803,6815,3386,0.49772159341467,3374,0.495084372707263
"16","NOORESTAN","1607","MANDOL",4879,0,0,4879,Inf,4879,Inf
"16","NOORESTAN","1608","BARGEMATAL",11291,10462,10477,829,0.079239151213917,814,0.0776939963730075
"17","BADAKHSHAN","1701","FAYZABAD",30527,28499,28186,2028,0.0711603915926875,2341,0.0830554175831973
"17","BADAKHSHAN","1702","ARGO",32995,29679,29734,3316,0.111728831833957,3261,0.109672428869308
"17","BADAKHSHAN","1703","ARGHANCHKHWA",3795,3682,3662,113,0.0306898424769147,133,0.0363189513926816
"17","BADAKHSHAN","1704","YAFTAL SUFLA",23703,21628,21635,2075,0.0959404475679674,2068,0.0955858562514444
"17","BADAKHSHAN","1705","KHASH",10432,9334,9444,1098,0.117634454681808,988,0.104616687844134
"17","BADAKHSHAN","1706","BAHARAK",15846,14229,14248,1617,0.113641155386886,1598,0.112156092083099
"17","BADAKHSHAN","1707","DARAYEM",17977,16169,16193,1808,0.111818912734245,1784,0.110171061569814
"17","BADAKHSHAN","1708","KOHESTAN",3220,3028,3064,192,0.0634081902245707,156,0.0509138381201044
"17","BADAKHSHAN","1709","YAWAN",14529,13307,13362,1222,0.0918313669497257,1167,0.0873372249663224
"17","BADAKHSHAN","1710","JURM",14891,13598,13728,1293,0.0950875128695396,1163,0.084717365967366
"17","BADAKHSHAN","1711","TESHKAN",13205,11982,12039,1223,0.102069771323652,1166,0.0968518979981726
"17","BADAKHSHAN","1712","SHUHADA",9714,9295,9316,419,0.0450779989241528,398,0.0427221983683985
"17","BADAKHSHAN","1713","SHAHR BUZORG",15103,13312,13313,1791,0.134540264423077,1790,0.134455043942012
"17","BADAKHSHAN","1714","RAGHESTAN",7867,7097,7097,770,0.108496547837114,770,0.108496547837114
"17","BADAKHSHAN","1715","KESHEM",40246,35237,35246,5009,0.142151715526293,5000,0.141860069227714
"17","BADAKHSHAN","1716","WARDOJ",0,0,0,0,NA,0,NA
"17","BADAKHSHAN","1717","TAGAB",7196,6626,6629,570,0.086024750980984,567,0.0855332629355861
"17","BADAKHSHAN","1718","YAMGAN",0,0,0,0,NA,0,NA
"17","BADAKHSHAN","1719","SHEGHNAN",7849,7355,7356,494,0.0671651937457512,493,0.0670201196302338
"17","BADAKHSHAN","1720","KHWAHAN",7245,6727,6730,518,0.077003121748179,515,0.0765230312035661
"17","BADAKHSHAN","1721","KOFAB",8740,8207,8215,533,0.064944559522359,525,0.0639074863055386
"17","BADAKHSHAN","1722","DARWAZ PAYEN (MAMAY)",8917,8013,8020,904,0.112816672906527,897,0.111845386533666
"17","BADAKHSHAN","1723","ESHKASHEM",5588,5296,5307,292,0.0551359516616314,281,0.0529489353683814
"17","BADAKHSHAN","1724","SHAKI",6443,5867,5867,576,0.0981762399863644,576,0.0981762399863644
"17","BADAKHSHAN","1725","ZEBAK",3240,2951,2957,289,0.097932904100305,283,0.0957051065268854
"17","BADAKHSHAN","1726","KERAN WA MENJAN",3876,3499,3504,377,0.107745070020006,372,0.106164383561644
"17","BADAKHSHAN","1727","DARWAZ BALA (NESAY)",7232,6714,6710,518,0.0771522192433721,522,0.0777943368107303
"17","BADAKHSHAN","1728","WAKHAN",4951,4464,4467,487,0.109094982078853,484,0.10835012312514
"18","TAKHAR","1801","TALUQAN",70062,67739,67647,2323,0.0342933908088398,2415,0.0357000310435053
"18","TAKHAR","1802","HAZARSUMOCH",7139,7078,7082,61,0.00861825374399548,57,0.00804857384919514
"18","TAKHAR","1803","BAHARAK",14230,13775,13793,455,0.0330308529945554,437,0.0316827376205322
"18","TAKHAR","1804","BANGI",17157,16426,16441,731,0.0445026178010471,716,0.0435496624292926
"18","TAKHAR","1805","CHAL",12647,11733,11746,914,0.0778999403392142,901,0.0767069640728759
"18","TAKHAR","1806","NAMAKAB",6156,4205,4205,1951,0.46397146254459,1951,0.46397146254459
"18","TAKHAR","1807","KALAFGAN",20003,18897,18917,1106,0.0585278086468752,1086,0.0574086800232595
"18","TAKHAR","1808","FARKHAR",21838,21186,21225,652,0.0307750401208345,613,0.0288810365135453
"18","TAKHAR","1809","KHWAJAGHAR",15621,7993,7993,7628,0.954335043162767,7628,0.954335043162767
"18","TAKHAR","1810","RUSTAQ",47751,45049,45045,2702,0.0599791338320495,2706,0.0600732600732601
"18","TAKHAR","1811","ESHKAMESH",21517,21305,21302,212,0.00995071579441446,215,0.0100929490188715
"18","TAKHAR","1812","DASHT QALA",5808,836,835,4972,5.94736842105263,4973,5.95568862275449
"18","TAKHAR","1813","WARSAJ",16206,15552,15553,654,0.0420524691358025,653,0.0419854690413425
"18","TAKHAR","1814","KHWAJA BAHAUDIN",8238,7559,7556,679,0.0898266966529964,682,0.0902593965060879
"18","TAKHAR","1815","DARQAD",1358,1124,1124,234,0.208185053380783,234,0.208185053380783
"18","TAKHAR","1816","CHAHAB",24207,23464,23472,743,0.0316655301738834,735,0.0313139059304703
"18","TAKHAR","1817","YANGI QALA",6630,5257,5261,1373,0.261175575423245,1369,0.260216688842425
"19","KUNDUZ","1901","KUNDUZ",79562,77761,77100,1801,0.0231607103818109,2462,0.0319325551232166
"19","KUNDUZ","1902","CHAHAR DARAH",6711,3598,3622,3113,0.865202890494719,3089,0.85284373274434
"19","KUNDUZ","1903","ALI ABAD",9688,7815,7841,1873,0.239667306461932,1847,0.235556689197806
"19","KUNDUZ","1904","KHAN ABAD",23761,22840,23375,921,0.0403239929947461,386,0.0165133689839572
"19","KUNDUZ","1905","EMAM SAHEB",50551,41147,41212,9404,0.228546431088536,9339,0.226608754731632
"19","KUNDUZ","1906","DASHT ARCHI",9757,9277,9286,480,0.0517408645036111,471,0.0507215162610381
"19","KUNDUZ","1907","QALAE ZAL",2656,2583,2585,73,0.0282617111885405,71,0.0274661508704062
"19","KUNDUZ","1908","KALBAD",0,0,0,0,NA,0,NA
"19","KUNDUZ","1909","GULTAPA",0,0,0,0,NA,0,NA
"19","KUNDUZ","1910","AQTASH",9860,4781,4779,5079,1.06233005647354,5081,1.06319313663946
"20","SAMANGAN","2001","AYBAK",38427,32828,33728,5599,0.170555623248446,4699,0.139320445920304
"20","SAMANGAN","2002","HAZRATE SULTAN",17339,17280,17281,59,0.00341435185185185,58,0.00335628725189514
"20","SAMANGAN","2003","KHURAM WA SARBAGH",9807,9373,9378,434,0.046303211351755,429,0.045745361484325
"20","SAMANGAN","2004","FIROZ NAKHCHEER",6191,6027,6028,164,0.0272108843537415,163,0.0270404777704048
"20","SAMANGAN","2005","ROYE DOAB",19912,19685,19687,227,0.0115316230632461,225,0.0114288616853761
"20","SAMANGAN","2006","DARAE SOFE PAYEN",19052,18870,19113,182,0.00964493905670376,-61,-0.00319154502171297
"20","SAMANGAN","2007","DARAE SOFE BALA",30776,30144,30163,632,0.0209660297239915,613,0.0203229121771707
"21","BALKH","2101-01","MAZARE SHARIF NAHIA 01",22836,20495,20461,2341,0.11422298121493,2375,0.116074483163091
"21","BALKH","2101-02","MAZARE SHARIF NAHIA 02",9949,9824,9815,125,0.0127239413680782,134,0.0136525725929699
"21","BALKH","2101-03","MAZARE SHARIF NAHIA 03",14962,13377,13360,1585,0.118486955221649,1602,0.119910179640719
"21","BALKH","2101-04","MAZARE SHARIF NAHIA 04",12083,9432,9415,2651,0.281064461407973,2668,0.283377588953797
"21","BALKH","2101-05","MAZARE SHARIF NAHIA 05",20707,19361,19326,1346,0.0695212024172305,1381,0.071458139294215
"21","BALKH","2101-06","MAZARE SHARIF NAHIA 06",8987,8527,8501,460,0.0539462882608186,486,0.0571697447359134
"21","BALKH","2101-07","MAZARE SHARIF NAHIA 07",14544,13625,13608,919,0.0674495412844037,936,0.0687830687830688
"21","BALKH","2101-08","MAZARE SHARIF NAHIA 08",15292,14472,15051,820,0.056661138750691,241,0.0160122251013222
"21","BALKH","2101-09","MAZARE SHARIF NAHIA 09",9299,8497,8474,802,0.0943862539719901,825,0.097356620250177
"21","BALKH","2101-10","MAZARE SHARIF NAHIA 10",17866,16821,16199,1045,0.0621247250460734,1667,0.10290758688808
"21","BALKH","2102","NAHR SHAHI",28701,27203,27238,1498,0.0550674557953167,1463,0.0537117262647772
"21","BALKH","2103","DEHDADI",28943,27072,27105,1871,0.0691119976359338,1838,0.0678103670909426
"21","BALKH","2104","CHARKENT",20157,19869,19902,288,0.0144949418692435,255,0.0128127826349111
"21","BALKH","2105","MARMUL",9254,9159,9166,95,0.0103723113877061,88,0.00960069823259873
"21","BALKH","2106","BALKH",42026,41228,41965,798,0.0193557776268555,61,0.00145359227928035
"21","BALKH","2107","SHOLGARA",49114,47869,48449,1245,0.0260084814807078,665,0.013725773493777
"21","BALKH","2108","CHEMTAL",19582,19297,19341,285,0.01476913509872,241,0.0124605759784913
"21","BALKH","2109","DAWLATABAD",18146,17931,17260,215,0.0119904076738609,886,0.051332560834299
"21","BALKH","2110","KHULM",20311,19715,19727,596,0.0302307887395384,584,0.02960409590916
"21","BALKH","2111","CHARBOLAK",20705,17946,17939,2759,0.153738994762064,2766,0.154189196722225
"21","BALKH","2112","SHORTEPA",9629,9364,9365,265,0.0282998718496369,264,0.0281900694073679
"21","BALKH","2113","KALDAR",9212,8336,8342,876,0.105086372360845,870,0.104291536801726
"21","BALKH","2114","KUSHENDEH",21300,20580,20581,720,0.0349854227405248,719,0.0349351343472135
"21","BALKH","2115","ZARI",28362,27815,27228,547,0.0196656480316376,1134,0.0416483032172763
"22","SARE PUL","2201","SARE PUL",50578,48756,48779,1822,0.0373697596193289,1799,0.0368806248590582
"22","SARE PUL","2202","SAYAD",7063,6388,6381,675,0.105666875391359,682,0.106879799404482
"22","SARE PUL","2203","KOHESTANAT",0,0,0,0,NA,0,NA
"22","SARE PUL","2204","SOZMAQALA",6460,6114,6119,346,0.0565914295060517,341,0.0557280601405458
"22","SARE PUL","2205","SANCHARAK",28609,28040,28042,569,0.0202924393723252,567,0.0202196704942586
"22","SARE PUL","2206","GOSFANDI",17523,17076,17074,447,0.0261770906535488,449,0.0262972941314279
"22","SARE PUL","2207","BALKHAB",30715,29226,29225,1489,0.0509477862177513,1490,0.05098374679213
"23","GHOR","2301","FEROZKOH (CHEGHCHERAN)",72451,71082,71185,1369,0.0192594468360485,1266,0.017784645641638
"23","GHOR","2302","DOLAYNA",16590,15294,15279,1296,0.0847391133777952,1311,0.0858040447673277
"23","GHOR","2303","DAWLATYAR",26185,25359,25159,826,0.0325722623131827,1026,0.04078063516038
"23","GHOR","2304","CHARSADA",6536,6299,6299,237,0.0376250198444198,237,0.0376250198444198
"23","GHOR","2305","PASABAND",5042,4843,4872,199,0.0410902333264505,170,0.0348932676518883
"23","GHOR","2306","SHAHRAK",29421,27753,27765,1668,0.0601016106366879,1656,0.0596434359805511
"23","GHOR","2307","LAL WA SARJANGAL",42566,41235,41341,1331,0.0322784042682187,1225,0.0296316005902131
"23","GHOR","2308","TAYWARA",22132,19601,19546,2531,0.129126064996684,2586,0.132303284559501
"23","GHOR","2309","TOLAK",22100,20685,20623,1415,0.068407058254774,1477,0.0716190660912573
"23","GHOR","2310","SAGHAR",7210,6824,6779,386,0.0565650644783118,431,0.063578698923145
"24","DAYKUNDI","2401","NILI",19042,17867,17870,1175,0.065763698438462,1172,0.0655847789591494
"24","DAYKUNDI","2402","SHAHRESTAN",27361,26880,26855,481,0.0178943452380952,506,0.018841928877304
"24","DAYKUNDI","2403","PATO",11385,10862,10854,523,0.048149512060394,531,0.048922056384743
"24","DAYKUNDI","2404","ESHTARLAY",17590,17088,17102,502,0.02937734082397,488,0.0285346743070986
"24","DAYKUNDI","2405","KHADER",17775,16668,17032,1107,0.066414686825054,743,0.0436237670267731
"24","DAYKUNDI","2406","KITI",20980,20540,20533,440,0.0214216163583252,447,0.0217698339258754
"24","DAYKUNDI","2407","MERAMOR",29057,28334,28427,723,0.0255170466577257,630,0.0221620290568825
"24","DAYKUNDI","2408","SANG TAKHT",17126,16346,16359,780,0.0477180961703169,767,0.0468855064490495
"24","DAYKUNDI","2409","KAJRAN",12842,12357,12372,485,0.0392490086590596,470,0.0379890074361461
"25","URUZGAN","2501","TIRENKOT",31673,29863,29937,1810,0.0606101195459264,1736,0.0579884423956976
"25","URUZGAN","2502","DEHRAWUD",13723,13295,13273,428,0.0321925535915758,450,0.0339034129435697
"25","URUZGAN","2503","CHORA",9878,5615,5585,4263,0.759216384683882,4293,0.768666069829901
"25","URUZGAN","2504","SHAHED HASAS",18,0,0,18,Inf,18,Inf
"25","URUZGAN","2505","KHASURUZGAN",0,0,0,0,NA,0,NA
"25","URUZGAN","2506","CHENARTO",1660,1391,1374,269,0.193386053199137,286,0.208151382823872
"25","URUZGAN","2507","GIZAB",6693,6161,6160,532,0.0863496185684142,533,0.086525974025974
"26","ZABUL","2601","QALAT",31380,30922,30903,458,0.01481146109566,477,0.0154353946218814
"26","ZABUL","2602","TARNAK WA JALDAK",5681,5390,5408,291,0.0539888682745826,273,0.0504807692307692
"26","ZABUL","2603","SHINKAI",4166,3905,3915,261,0.0668373879641485,251,0.0641123882503193
"26","ZABUL","2604","MEZAN",2108,2073,2077,35,0.0168837433671008,31,0.0149253731343284
"26","ZABUL","2605","ARGHANDAB",405,375,375,30,0.08,30,0.08
"26","ZABUL","2606","SHAHJOY",15495,14970,14972,525,0.0350701402805611,523,0.0349318728292813
"26","ZABUL","2607","DAYCHOPAN",0,0,0,0,NA,0,NA
"26","ZABUL","2608","ATGHAR",1482,1436,1437,46,0.032033426183844,45,0.0313152400835073
"26","ZABUL","2609","NAWBAHAR",681,576,577,105,0.182291666666667,104,0.180242634315425
"26","ZABUL","2610","SHUMULZAY",5091,5076,5078,15,0.00295508274231678,13,0.0025600630169358
"26","ZABUL","2611","KAKAR",0,0,0,0,NA,0,NA
"27","KANDAHAR","2701-01","KANDAHAR NAHIA 01",55401,52469,53008,2932,0.0558806152204159,2393,0.0451441291880471
"27","KANDAHAR","2701-02","KANDAHAR NAHIA 02",50008,48093,47515,1915,0.0398186846318591,2493,0.0524676417973272
"27","KANDAHAR","2701-03","KANDAHAR NAHIA 03",8760,7431,7396,1329,0.178845377472749,1364,0.184424012979989
"27","KANDAHAR","2701-04","KANDAHAR NAHIA 04",48799,46826,46741,1973,0.0421347114850724,2058,0.0440298667123083
"27","KANDAHAR","2701-05","KANDAHAR NAHIA 05",6713,6522,6517,191,0.0292854952468568,196,0.0300751879699248
"27","KANDAHAR","2701-06","KANDAHAR NAHIA 06",8221,8016,8016,205,0.0255738522954092,205,0.0255738522954092
"27","KANDAHAR","2701-07","KANDAHAR NAHIA 07",13805,13645,14235,160,0.0117259069256138,-430,-0.0302072356866877
"27","KANDAHAR","2701-08","KANDAHAR NAHIA 08",12984,13027,13015,-43,-0.00330083672372764,-31,-0.00238186707645025
"27","KANDAHAR","2701-09","KANDAHAR NAHIA 09",29486,28776,28805,710,0.0246733388935224,681,0.0236417288665162
"27","KANDAHAR","2701-10","KANDAHAR NAHIA 10",47315,46271,46302,1044,0.0225627282747293,1013,0.0218781046175111
"27","KANDAHAR","2701-13","KANDAHAR NAHIA 13",5755,5960,5951,-205,-0.0343959731543624,-196,-0.0329356410687279
"27","KANDAHAR","2702","ARGHANDAB",25316,24570,24584,746,0.0303622303622304,732,0.0297754637162382
"27","KANDAHAR","2703","DAMAN",20452,18992,19012,1460,0.0768744734625105,1440,0.0757416368609299
"27","KANDAHAR","2704","PANJWAYE",26385,25728,25709,657,0.0255363805970149,676,0.0262942938270645
"27","KANDAHAR","2705","ZHERAY",31217,30491,30500,726,0.0238103046800695,717,0.0235081967213115
"27","KANDAHAR","2706","SHAHWALEKOT",4919,3902,3902,1017,0.260635571501794,1017,0.260635571501794
"27","KANDAHAR","2707","KHAKREZ",482,409,408,73,0.178484107579462,74,0.181372549019608
"27","KANDAHAR","2708","ARGHESTAN",9679,9231,9232,448,0.0485321200303326,447,0.0484185441941075
"27","KANDAHAR","2709","GHORAK",585,564,562,21,0.0372340425531915,23,0.0409252669039146
"27","KANDAHAR","2710","MAYWAND",8675,8099,8104,576,0.0711198913446104,571,0.0704590325765054
"27","KANDAHAR","2711","SPENBOLDAK",103299,86082,86146,17217,0.200006970098278,17153,0.199115455157523
"27","KANDAHAR","2712","NESH",511,0,0,511,Inf,511,Inf
"27","KANDAHAR","2713","MIYANSHIN",1003,909,909,94,0.103410341034103,94,0.103410341034103
"27","KANDAHAR","2714","SHORABAK",348,203,203,145,0.714285714285714,145,0.714285714285714
"27","KANDAHAR","2715","MAROF",0,0,0,0,NA,0,NA
"27","KANDAHAR","2716","REG",319,161,161,158,0.981366459627329,158,0.981366459627329
"27","KANDAHAR","2717","DAND",25908,25233,25218,675,0.0267506836285816,690,0.0273614085177254
"27","KANDAHAR","2718","TAKHTAPUL",12222,11374,11388,848,0.0745560049235098,834,0.0732349841938883
"28","JAWZJAN","2801","SHEBERGHAN",64129,57905,57795,6224,0.107486400138157,6334,0.109594255558439
"28","JAWZJAN","2802","KHWAJA DOKOH",12812,12169,12202,643,0.0528391815268305,610,0.0499918046221931
"28","JAWZJAN","2803","KHANEQA",2678,2576,2578,102,0.0395962732919255,100,0.0387897595034911
"28","JAWZJAN","2804","MENGAJEK",821,814,814,7,0.0085995085995086,7,0.0085995085995086
"28","JAWZJAN","2805","QOSHTEPA",2622,2494,2494,128,0.0513231756214916,128,0.0513231756214916
"28","JAWZJAN","2806","KHAMYAB",115,116,116,-1,-0.00862068965517241,-1,-0.00862068965517241
"28","JAWZJAN","2807","AQCHA",12085,11930,11936,155,0.0129924559932942,149,0.0124832439678284
"28","JAWZJAN","2808","FAYZABAD",5001,4835,4850,166,0.0343329886246122,151,0.0311340206185567
"28","JAWZJAN","2809","MARDYAN",111,0,0,111,Inf,111,Inf
"28","JAWZJAN","2810","QARQEEN",2319,2315,2315,4,0.00172786177105832,4,0.00172786177105832
"28","JAWZJAN","2811","DARZAB",693,0,0,693,Inf,693,Inf
"29","FARYAB","2901","MAYMANA",48898,37208,37081,11690,0.31417974629112,11817,0.318680725978264
"29","FARYAB","2902","PASHTONKOT",20772,16504,16551,4268,0.258603974793989,4221,0.255029907558456
"29","FARYAB","2903","KHWAJA SABZPOSH",2009,1675,1679,334,0.199402985074627,330,0.196545562835021
"29","FARYAB","2904","ALMAR",10686,10514,10515,172,0.016359140194027,171,0.016262482168331
"29","FARYAB","2905","BELCHERAGH",14925,14407,14418,518,0.035954744221559,507,0.0351643778610071
"29","FARYAB","2906","SHIRINTAGAB",3701,3622,3622,79,0.0218111540585312,79,0.0218111540585312
"29","FARYAB","2907","QAYSAR",41543,39254,39289,2289,0.0583125286594997,2254,0.0573697472575021
"29","FARYAB","2908","GURZIWAN",16392,10907,10940,5485,0.502888053543596,5452,0.49835466179159
"29","FARYAB","2909","DAWLATABAD",5419,5296,5296,123,0.0232250755287009,123,0.0232250755287009
"29","FARYAB","2910","KOHESTAN",1185,0,0,1185,Inf,1185,Inf
"29","FARYAB","2911","QARAMQUL",7373,7342,7347,31,0.00422228275674203,26,0.0035388593983939
"29","FARYAB","2912","QURGHAN",11571,11329,11356,242,0.0213611086591932,215,0.0189327227897147
"29","FARYAB","2913","ANDKHOY",25449,22545,22537,2904,0.128809048569528,2912,0.129209743976572
"29","FARYAB","2914","KHAN CHAR BAGH",10287,8963,8974,1324,0.14771839785786,1313,0.146311566748384
"30","HELMAND","3001","LASHKARGAH",168193,162690,163093,5503,0.0338250660765874,5100,0.0312705021061603
"30","HELMAND","3002","NADALI",41532,39757,39695,1775,0.0446462258218678,1837,0.0462778687492127
"30","HELMAND","3003","NAWAE BARAKZAYE",38036,35789,35566,2247,0.0627846545027802,2470,0.0694483495473205
"30","HELMAND","3004","NAHR SARAJ",49674,37158,37128,12516,0.336831906991765,12546,0.337912087912088
"30","HELMAND","3005","WASHIR",4069,3898,3892,171,0.0438686505900462,177,0.0454779033915725
"30","HELMAND","3006","GARMSER",9301,8292,8282,1009,0.121683550410034,1019,0.123037913547452
"30","HELMAND","3007","NAWZAD",0,0,0,0,NA,0,NA
"30","HELMAND","3008","SANGEEN",1675,926,926,749,0.808855291576674,749,0.808855291576674
"30","HELMAND","3009","MOSAQALA",0,0,0,0,NA,0,NA
"30","HELMAND","3010","KAJAKI",641,367,357,274,0.746594005449591,284,0.795518207282913
"30","HELMAND","3011","REG(KHAN NESHIN)",0,0,0,0,NA,0,NA
"30","HELMAND","3012","BAGHRAN",0,0,0,0,NA,0,NA
"30","HELMAND","3013","DISHO",0,0,0,0,NA,0,NA
"30","HELMAND","3014","MARJA",10146,9455,9432,691,0.0730830248545743,714,0.0756997455470738
"30","HELMAND","3015","NAWAMISH",8899,8046,8118,853,0.106015411384539,781,0.0962059620596206
"31","BADGHIS","3101","QALAE NAW",32256,31956,29160,300,0.00938790837401427,3096,0.106172839506173
"31","BADGHIS","3102","ABKAMARI",13697,14941,13219,-1244,-0.0832608259152667,478,0.03616007262274
"31","BADGHIS","3103","MUQUR",4359,4712,4144,-353,-0.0749151103565365,215,0.0518822393822394
"31","BADGHIS","3104","QADEES",5227,4716,4646,511,0.108354537743851,581,0.125053809728799
"31","BADGHIS","3104","QADIS",0,0,0,0,NA,0,NA
"31","BADGHIS","3105","MURGHAB",16450,16605,15221,-155,-0.00933453778982234,1229,0.0807437093489258
"31","BADGHIS","3106","JAWAND",16975,17152,15923,-177,-0.0103194962686567,1052,0.0660679520190919
"31","BADGHIS","3107","GHORMACH",12407,4225,5302,8182,1.93656804733728,7105,1.34006035458318
"32","HERAT","3201-01","HERAT NAHIA 01",14003,11276,11279,2727,0.241841078396595,2724,0.241510772231581
"32","HERAT","3201-02","HERAT NAHIA 02",4957,4388,5555,569,0.129671832269827,-598,-0.107650765076508
"32","HERAT","3201-03","HERAT NAHIA 03",14106,13693,13675,413,0.0301613963338932,431,0.0315173674588665
"32","HERAT","3201-04","HERAT NAHIA 04",8397,8322,8307,75,0.00901225666906993,90,0.0108342361863489
"32","HERAT","3201-05","HERAT NAHIA 05",30963,29915,30466,1048,0.0350325923449774,497,0.0163132672487363
"32","HERAT","3201-06","HERAT NAHIA 06",18702,17868,18588,834,0.0466756212222968,114,0.00613298902517753
"32","HERAT","3201-07","HERAT NAHIA 07",19360,17562,16779,1798,0.10238013893634,2581,0.153823231420228
"32","HERAT","3201-08","HERAT NAHIA 08",16029,15445,15425,584,0.0378115895111687,604,0.0391572123176661
"32","HERAT","3201-09","HERAT NAHIA 09",12936,12537,12543,399,0.0318257956448911,393,0.0313322171729251
"32","HERAT","3201-10","HERAT NAHIA 10",12472,11739,11720,733,0.0624414345344578,752,0.0641638225255973
"32","HERAT","3201-11","HERAT NAHIA 11",13975,13748,13730,227,0.016511492580739,245,0.0178441369264385
"32","HERAT","3201-12","HERAT NAHIA 12",22294,20784,21093,1510,0.0726520400307929,1201,0.0569383207699237
"32","HERAT","3201-13","HERAT NAHIA 13",23075,19155,19121,3920,0.204646306447403,3954,0.206788347889755
"32","HERAT","3201-14","HERAT NAHIA 14",4708,4236,3052,472,0.111425873465534,1656,0.54259501965924
"32","HERAT","3201-15","HERAT NAHIA 15",4749,3312,3318,1437,0.433876811594203,1431,0.43128390596745
"32","HERAT","3202","ENJEEL",72254,71162,71357,1092,0.0153452685421995,897,0.0125705957369284
"32","HERAT","3203","GUZARA",57009,54728,54828,2281,0.0416788481216196,2181,0.0397789450645656
"32","HERAT","3204","KARUKH",29832,27494,28723,2338,0.0850367352876991,1109,0.0386101730320649
"32","HERAT","3205","ZENDAJAN",15899,15159,15169,740,0.0488158849528333,730,0.0481244643681192
"32","HERAT","3206","PASHTON ZARGHON",19811,17973,17985,1838,0.10226450787292,1826,0.101529051987768
"32","HERAT","3207","KUSHK",34992,33644,33658,1348,0.0400665794792534,1334,0.039633965179155
"32","HERAT","3208","GULRAN",5635,5469,5480,166,0.0303528981532273,155,0.0282846715328467
"32","HERAT","3209","ADRASKAN",7557,6644,7133,913,0.137417218543046,424,0.0594420300014019
"32","HERAT","3210","KUSHK KUHNA",15739,15524,15536,215,0.0138495233187323,203,0.0130664263645726
"32","HERAT","3211","GHORYAN",35287,34043,34041,1244,0.0365420203859824,1246,0.0366029200082254
"32","HERAT","3212","OBI",11642,11264,11269,378,0.0335582386363636,373,0.0330996539178277
"32","HERAT","3213","KOHSAN",27209,25676,25669,1533,0.0597055616139586,1540,0.0599945459503681
"32","HERAT","3214","SHEENDND",9681,8441,8453,1240,0.146902025826324,1228,0.145273867266059
"32","HERAT","3215","FARSI",3519,2800,2786,719,0.256785714285714,733,0.263101220387653
"32","HERAT","3216","CHISHT SHAREF",2848,1400,1401,1448,1.03428571428571,1447,1.03283369022127
"32","HERAT","3217","ZIR KOH",0,0,0,0,NA,0,NA
"32","HERAT","3218","PUSHT KOH",0,0,0,0,NA,0,NA
"32","HERAT","3219","KOHE ZOR",1098,1113,1112,-15,-0.0134770889487871,-14,-0.012589928057554
"32","HERAT","3220","ZAWOL",3317,2627,2635,690,0.262657023220404,682,0.258823529411765
"33","FARAH","3301","FARAH",52108,52010,50614,98,0.0018842530282638,1494,0.0295175247955111
"33","FARAH","3302","PUSHTROD",274,296,270,-22,-0.0743243243243243,4,0.0148148148148148
"33","FARAH","3303","KHAK SAFID",1563,0,0,1563,Inf,1563,Inf
"33","FARAH","3304","QALAYE KAH",1035,1142,1030,-107,-0.0936952714535902,5,0.00485436893203883
"33","FARAH","3305","SHIBKOH",322,344,312,-22,-0.063953488372093,10,0.032051282051282
"33","FARAH","3306","BALABLOK",3054,2895,2646,159,0.0549222797927461,408,0.154195011337868
"33","FARAH","3307","ANARDARA",1833,1904,1771,-71,-0.0372899159663866,62,0.0350084697910785
"33","FARAH","3308","BAKWA",607,572,517,35,0.0611888111888112,90,0.174081237911025
"33","FARAH","3309","LASH JUWAYN",5153,5709,5107,-556,-0.0973900858293922,46,0.00900724495790092
"33","FARAH","3310","GULESTAN",662,677,637,-15,-0.0221565731166913,25,0.0392464678178964
"33","FARAH","3311","PURCHAMAN",2027,276,249,1751,6.34420289855072,1778,7.14056224899598
"34","NIMROZ","3401","ZARANJ",47760,46589,46602,1171,0.0251346884457705,1158,0.0248487189391013
"34","NIMROZ","3402","KANG",9946,10912,10920,-966,-0.0885263929618768,-974,-0.0891941391941392
"34","NIMROZ","3403","CHAKHANSOR",8495,9143,9145,-648,-0.0708738925954282,-650,-0.071077091306725
"34","NIMROZ","3404","CHAR BURJAK",8198,8406,8407,-208,-0.0247442303116821,-209,-0.0248602355180207
"34","NIMROZ","3405","KHASHROD",7081,6867,6846,214,0.0311635357506917,235,0.0343266140812153
"34","NIMROZ","3406","DELARAM",10460,10686,10679,-226,-0.0211491671345686,-219,-0.0205075381590037
